############gggg############
#..........n....ss........##
#..#########nnnn########..##
#..#.#..........#####.....##
#...@#..#########......##.##
####.#.......####..######.##
#.....#####...##...##......#
####....####....###..####.##
#....###.##..####lll##....##
#..##....###..##..####..####
#......##.....##.....##...##
#####..##..########..####..#
#..##......###.......#####.#
##.####.........####.......#
#...########################